1111111111111111111111111111
1PC0000E000000000000CC000001
11101110100000000CCC10000001
1000000000111111110000C00001
1011111100011111111000000001
10000000C000000C0000111111C1
1111111111111111111111111111