11111111111111
1P000110000011
1011E110011111
1C001110000011
11111110011111
11111110011111
11111111111111