11111
1P011
100C1
1E0V1
11111
