1111111111111
10010000000C1
1000011111111
1E00000V000P1
1111111111111
