111111111111111111111111111111111111111111111111111
1TTP01A10011AAAA101001AAAA0000H10HH010000100AA11TT1
1T1001H00000AA000000NHH0010A10A100HAA00H000000000T1
1H00000001100N0AA1110000000000000000N00010AAAHA0111
1H1000011AA11000101000CCCC000N00CCCCCCCC0000000N001
100001H10000A00000000C111C00000C11111111C0000001011
1AAH000011A00001000CC111CCC00C111CCCC111C0000010001
1000000N000101000CC1110111C0N0CCCCC111CC0000000N011
11001HA1010000CCC11100011C000CCC111CCC00N00A00TTTT1
11A0H00000000C1111111111C0C1111CCC00000N001000TEFT1
1010100N000000CCCCCC111CC0C111CCCCCCCC0000H100T00T1
1H10000110011000N00C111C0C11111111111C00000A1000001
1010A1010000AA1A000CCCCC0CCCCCCCCCCCC00000001AAAA11
1000000AAA0000000N0000000N00000N00000000000001A11T1
1TT0A100000HA01A10A1000AAH0010001HH01AA010000N10TT1
111111111111111111111111111111111111111111111111111
