N  ./srcs/sprites/cube3dtex/xpm/finestra.xpm
S   ./srcs/sprites/Walls/WallS.xpm
W     ./srcs/sprites/cube3dtex/xpm/monitor2.xpm
EA    ./srcs/sprites/cube3dtex/xpm/42window.xpm
EA  ./srcs/sprites/cube3dtex/xpm/42window.xpm
F   221,111,1
C   200,200,200
1111111111111111111111111111111111111111111111111
100000000000000000000000000000000000000000000001
111111111111111111111111111111111111111111111111
1111111111111111111111111111111111
1111111111111111111111111111111111
1111111111111111111111111111111111
1111111111111111111111111111111111
1111111111111111111111111111111111
1111111111111111111111111111111111
1111111111111111111111111111111111
1111111111111111111111111111111111
1111111111111111111111111111111111
1111111111111111111111111111111111
1111111111111111111111111111111111
1111111111111111111111111111111111
1111111111111111111111111111111111
1111111111111111111111111111111111
1111111111111111111111111111111111
1111111111111111111111111111111111
111111111111           11111111111
111111111111 111111111 11111111111
111111111111 100000001 11111111111
111111111111 100N00001 1111111111
111111111111 100000001 11111111111
111111111111 100000001 11111111111
111111111111 111111111 11111111111
111111111111           11111111111
1111111111111111111111111111111111
1111111111111111111111111111111111
1111111111111111111111111111111111
1111111111111111111111111111111111
1111111111111111111111111111111111
1111111111111111111111111111111111
1111111111111111111111111111111111
1111111111111111111111111111111111
1111111111111111111111111111111111
1111111111111111111111111111111111
1111111111111111111111111111111111
1111111111111111111111111111111111
1111111111111111111111111111111111
1111111111111111111111111111111111
1111111111111111111111111111111111
11111111111111111111111111111111111
1000000000000000000000000000000011111111111111111111111111
1111111111111111111111111111111111111
