111111111111111111111111111111
110000000000100000NC1111111111
1100111111000N1111001111111111
11P011111100011000000110N11111
1111110000001000000C1110011111
1111111000000011100N1110111111
111111111000011C00000000011111
1111111111001000000C1111011111
1111N0111100001110001111011111
111100000000011CN0000001011111
111111111111111111111111011111
111111111111111000000000011111
111111111111111011111111111111
11N000000000000000000000000E11
111111111111111111111111111111